1,1,1,1,1,1,1,1,1,1,1,1,1,1,1,
1,7,3,3,3,3,3,3,3,3,3,3,3,5,1,
1,3,1,1,1,1,1,1,1,1,1,1,1,3,1,
1,3,1,2,1,5,3,3,3,3,3,3,3,6,1,
1,3,1,1,1,3,1,1,1,1,1,1,1,1,1,
1,3,1,2,1,3,1,2,1,2,1,2,1,2,1,
1,3,1,1,1,3,1,1,1,1,1,1,1,1,1,
1,3,1,2,1,7,3,3,3,3,3,3,3,3,3,
1,3,1,1,1,1,1,1,1,1,1,1,1,1,1,